#,#,#,#,#,#,#,#,#,#,#,#,#,#,#,#
#,.,.,#,#,.,#,#,.,.,.,.,.,.,.,#
#,.,#,.,.,.,.,.,.,.,.,#,~,#,.,#
#,.,.,~,.,#,#,#,.,#,.,#,#,#,.,#
#,.,#,#,.,.,.,.,.,#,.,.,.,.,~,#
#,.,.,.,#,~,#,.,.,.,.,#,.,#,~,#
#,.,#,.,.,.,.,.,#,#,.,~,.,#,~,#
#,.,.,.,.,#,#,.,.,#,.,#,.,#,.,#
#,.,#,#,.,.,~,~,.,.,.,.,.,.,.,#
#,.,~,.,.,#,#,#,#,.,#,#,.,#,.,#
#,#,#,#,.,.,.,.,.,.,.,~,.,.,~,#
#,#,#,#,#,#,#,#,#,#,#,#,#,#,#,#
